0,1,1,0,0,-1,0,4000,3600,1,2,3,0
1,0,1,0,0,-1,0,300,180,1,2,4,0
2,0,1,0,0,-1,0,300,180,1,2,5,0
3,0,1,0,0,-1,0,300,180,1,2,6,0
4,0,2,0,0,50,0,5,10,1,2,3,0
5,0,1,0,0,-1,0,180,120,1,2,4,0
6,0,1,0,0,-1,0,180,120,1,2,5,0
7,0,1,0,0,-1,0,90,60,1,2,6,0
8,0,1,0,0,-1,0,90,60,1,2,8,0
9,0,3,0,0,-1,0,180,120,1,2,7,0
10,0,1,0,0,-1,0,120,80,1,2,3,0
11,0,1,0,0,-1,0,120,80,1,2,6,0
12,0,1,0,0,-1,0,120,80,1,2,7,0
13,0,1,0,0,-1,0,120,80,1,2,4,0
14,0,2,0,0,70,0,8,15,1,2,6,0
15,0,1,0,0,-1,0,120,80,1,2,5,0
16,0,1,0,0,-1,0,120,80,1,2,6,0
17,0,1,0,0,-1,0,120,80,1,2,8,0
18,0,1,0,0,-1,0,120,80,1,2,6,0
19,0,3,0,0,-1,0,180,120,1,2,7,0
20,0,1,0,0,-1,0,120,80,1,2,6,0
21,0,1,0,0,-1,0,120,80,1,2,8,0
22,0,1,0,0,-1,0,120,80,1,2,4,0
23,0,1,0,0,-1,0,120,80,1,2,5,0
24,0,2,0,0,70,0,8,15,1,2,6,0
25,0,1,0,0,-1,0,120,80,1,2,4,0
26,0,1,0,0,-1,0,120,80,1,2,8,0
27,0,1,0,0,-1,0,120,80,1,2,3,0
28,0,1,0,0,-1,0,120,80,1,2,5,0
29,0,3,0,0,-1,0,180,120,1,2,7,0
30,0,1,0,0,-1,0,120,80,1,2,5,0
31,0,1,0,0,-1,0,120,80,1,2,4,0
32,0,1,0,0,-1,0,120,80,1,2,6,0
33,0,1,0,0,-1,0,120,80,1,2,5,0
34,0,2,0,0,60,0,8,15,1,2,6,0
35,0,1,0,0,-1,0,120,80,1,2,3,0
36,0,1,0,0,-1,0,120,80,1,2,4,0
37,0,1,0,0,-1,0,120,80,1,2,3,0
38,0,1,0,0,-1,0,120,80,1,2,6,0
39,0,3,0,0,-1,0,180,120,1,2,7,0
40,0,1,0,0,-1,0,120,80,1,2,8,0
41,0,1,0,0,-1,0,120,80,1,2,5,0
42,0,1,0,0,-1,0,120,80,1,2,4,0
43,0,1,0,0,-1,0,120,80,1,2,8,0
44,0,2,0,0,50,0,8,15,1,2,7,0
45,0,1,0,0,-1,0,120,80,1,2,6,0
46,0,1,0,0,-1,0,120,80,1,2,6,0
47,0,1,0,0,-1,0,120,80,1,2,8,0
48,0,1,0,0,-1,0,120,80,1,2,6,0
49,0,3,0,0,-1,0,180,120,1,2,7,0
50,0,1,0,0,-1,0,120,80,1,2,6,0
51,0,1,0,0,-1,0,120,80,1,2,6,0
52,0,1,0,0,-1,0,120,80,1,2,6,0
53,0,1,0,0,-1,0,120,80,1,2,6,0
54,0,2,0,0,50,0,8,15,1,2,7,0
55,0,1,0,0,-1,0,120,80,1,2,6,0
56,0,1,0,0,-1,0,120,80,1,2,5,0
57,0,1,0,0,-1,0,120,80,1,2,8,0
58,0,1,0,0,-1,0,120,80,1,2,6,0
59,0,3,0,0,-1,0,180,120,1,2,7,0